NO ./bonus/textures/north.xpm
SO ./bonus/textures/south.xpm
WE ./bonus/textures/west.xpm
EA ./bonus/textures/east.xpm
D  ./bonus/textures/door.xpm
SM1 ./bonus/textures/wallsmiley1.xpm
SM2 ./bonus/textures/wallsmiley2.xpm
WIN1 ./bonus/textures/win1.xpm
WIN2 ./bonus/textures/win2.xpm
WIN3 ./bonus/textures/win3.xpm
WIN4 ./bonus/textures/win4.xpm
WIN5 ./bonus/textures/win5.xpm
WIN6 ./bonus/textures/win6.xpm
WIN7 ./bonus/textures/win7.xpm
WIN8 ./bonus/textures/win8.xpm
WIN9 ./bonus/textures/win9.xpm

F 189,126,0
C 208,211,211

11111111111111111111111111111111111111111111111111111111
10100001000000000000000000100D00000000000000000000000001
111000010111T1111100000000100D00000000000000000000000001
1XTE0000000000000000000000D00D000000000000TT000000000001
11100000000000000000000000100D000000000000TT000000000001
10100000000000000000000000100D00000000000000000000000001
10100000000000000000000000T00D00000000000000000000000001
10000000000000000001111111111111111111111111111111111111
111T1110011T110001111
101000001000000000001
101010101011111110001
100010100010000010001
111110101111101011101
100000101000101000001
101111101011101111111
101000001010100000101
101011111010111110101
101010001010100010101
101110101010101010101
100000101010001010001
111111101011111011101
100000101000100010001
101110101110101110111
101000100000100010101
101011111111111010101
100010000000000010001
1010101110111111111T1
101000001000000000TX1
111111111111111111111