NO ./textures/north.xpm
SO ./textures/south.xpm
WE ./textures/west.xpm
EA ./textures/east.xpm

F 59,37,6
C 0,0,0


1111111111111111111111111
1S0000000K110000000000001
1011000001110000000000001
1001000000D00000000000001
1111111111111111111111111
