NO ./mandatory/textures/north.xpm
SO ./mandatory/textures/south.xpm
WE ./mandatory/textures/west.xpm
EA ./mandatory/textures/east.xpm

F 59,3aa7,5254
C 0,0,14a0

1111111111111111111111111
1000000000110000000000001
1011S00001110000000000001
1001000000000000000000001
1111111111111111111111111
