NO ./textures/north.xpm
SO ./textures/south.xpm
WE ./textures/west.xpm
EA ./textures/east.xpm
D  ./textures/door.xpm
SM1 ./textures/wallsmiley1.xpm
SM2 ./textures/wallsmiley2.xpm

F 189,126,0
C 208,211,211

        1111111111111111111111111
        10000000001101D10000T1111
        1011000001110000000000001
        10010000000D0000N00000001
111111111111111111111111111111111